	
Firefox 拓展

	桌面版：
		复制链接/标签名称和地址：Copy the name and URL of a link or a Tab. 复制链接或标签页的名称和地址

		
		书签搜索: 右键搜索功能，见之前的文章。

		
		AgentX: User-Agent 切换。

		
		Bookmarklets context menu: 因为 CSP，有些小书签不能加载了，通过 Web Extensions 绕过好了。

		
		Containers On The Go: 自动创建和清除临时身份。每个身份的 cookies 等存储是相互独立的。

		
		Decentraleyes: 给流行 JavaScript 库建立一个本地 CDN。

		
		Drag-Select Link Text: 选择链接里的文本。（可惜不支持 X 选择区。）

		
		Foxy Gestures: 手势。

		
		FoxyImage: 有时候会遇到方向不对的图片，用这个修理一下。

		
		Google™ Translator (web-extension): 翻译。目前网页内的选择翻译坏掉了，不过工具栏按钮还可以用。

		
		HTTPS Everywhere

		
		Inoreader Companion: 为了在后台打开 InoReader 里的文章。

		
		Octotree: GitHub / BitBucket 文件树。

		
		Push to Kindle

		
		Redirect Link: 在互联网档案馆、Archive.is 或者 Google 缓存里寻找当前页面，或者存档之。

		
		Redirector: 自定义重定向。比如查看图像时直接跳转到大图、跳过各种重定向链接之类的。

		
		Referer Control: 反盗链有时候很烦的。

		
		Rotate and Zoom Image: 另一个旋转图片的工具。

		
		Stylus: 更换网站样式，比如把 GitHub 顶栏变成白色、已访问链接使用不同的颜色。

		
		Tampermonkey: 更大力地修改网站。我正在使用的脚本都放在这里了。

		
		Textarea Cache: 在网站写东西的时候，遇到浏览器、系统崩溃死机？网站突然挂了？写的东西可别丢了。

		
		uBlock Origin: 广告屏蔽。

		
		User-Agent Switcher: 另一个切换 User-Agent 的扩展。

		
		v2ex plus: v2ex 新消息提醒、查看被回复的评论等。

		
		VimFx: 使用 Vim 的方式操作火狐。这是一个旧式扩展，使用 nightly 的话开启 extensions.legacy.enabled 选项才可以用。（AMO 上的文件链接）

		
		Wappalyzer: 看看网站都用了哪些技术。

		
		wxIF: 查看图片元数据。没什么用。

		
		Bookmarks Organizer: 整理书签。默认禁用，想整理的时候启用一下下。

		
		ScrollAnywhere: 按住中键移动鼠标时滚动页面。因为和 Foxy Gestures 使用中键冲突，暂时禁用。


	
	
	
	
	
	
	
	
	
	
	
	
	
	
	
	
	
	
	
	
	
	
	
	
	
	
	
	
	
	
	
	
	
	
	
	